*******************X
XX*XXXXXXXXXXXXXXXXX
XX*****************X
XXXXXXXXXXXXXXXXXX*X
XX*****X*****X***X*X
XX*XXX*X*X*XXX*X*X*X
XX*X*X***X*X***X***X
XX*X*XXXXX*X*XXXXXXX
XX*X***X***X*******X
XX*X*XXX*XXXXXXXXX*X
XX*X***X*X*******X*X
XX*X*X*X*X*X*XXXXX*X
XX*X*X*X*X*X*****X*X
XX*X*X*X*X*XXXXX*X*X
XX*X*X*X*X*X***X***X
XX*XXX*X*X*X*X*XXXXX
XX*****X*X*X*X*****X
XXXXXX*X*X*XXXXX*X*X
XX*****X*********X*X
XXXXXXXXXXXXXXXXXX**
